dimensions=18x26
color=20, 20, 20
player=1, 1
BBBBBBBBBBBBBBBBBBBBBBBBBB
B           PPPPPP       B
BBBB BBBBBBBBBBBBBBBBBBB B
B              A B       B
BBBBBBBBBB   BEBEB   BBBBB
BBBBBBBBBBBBBB B B   BBBBB
B              B     BBBBB
B BBBBBBBBBBBBBBBBBBBBBBBB
B BBBBBBBBBBBBBB  E  BBBBB
B                 B  BBBBB 
BBBBBBBBBBBBBBBBBBB  AAAAB
B     E    E E    E  BBBBB
B B B    E      E    PPPPB 
B B BBBBBBBBBBBBBBBBBBBBBB
B B   E      P P P P P  BB
B BBBBBBBBBBBBBBBBBBBBB BB
B          E G E        BB
BBBBBBBBBBBBBBBBBBBBBBBBBB